[ ['+','+','+','+',...,'+','+','+','+','+','+','+'],
  ['+',' ',' ',' ',...,' ',' ',' ','+',' ',' ',' '],
  ['+',' ','+',' ',...,'+','+',' ','+',' ','+','+'],
  ['+',' ','+',' ',...,' ',' ',' ','+',' ','+','+'],
  ['+','+','+',' ',...,'+','+',' ','+',' ',' ','+'],
  ['+',' ',' ',' ',...,'+','+',' ',' ',' ',' ','+'],
  ['+','+','+','+',...,'+','+','+','+','+',' ','+'],
  ['+',' ',' ',' ',...,'+','+',' ',' ','+',' ','+'],
  ['+',' ','+','+',...,' ',' ','+',' ',' ',' ','+'],
  ['+',' ',' ',' ',...,' ',' ','+',' ','+','+','+'],
  ['+','+','+','+',...,'+','+','+',' ','+','+','+']]s